Calvin Klein IN2U Eau de Toilette  -  150 ml (For Men)	calvin klein
For The Love of Physics (Paperback)	physics
Nike Fission Deodorant Spray  -  200 ml (For Men)	nike-deodrant
Spoken English (With CD) 2nd Edition (Paperback)	spoken english
The C++ Programming Language 3 Edition (Paperback)	c programming
Sony Cybershot DSC-W610 Point & Shoot (Black)	sony cybershot
IBPS Bank Probationary Officers Management Trainees Common Written Exam. 1st Edition (Paperback)	written english
Tommy Hilfiger Analog Watch  - For Women (Silver)	tommy watch
Dr. Seuss's Beginner Book Collection (Boxed Set)	best-seller books
Panasonic SDR-S15 Camcorder (Silver)	camcorder
Study Writing : A Course in Written English for Academic Purposes 2nd Edition (Paperback)	written english
Data Structures and Algorithms For GATE: Solutions to all previous GATE questions since 1991 1st Edition (Paperback)	data structures algorithms
Mathematics Class-VIII (Paperback)	mathematics
C in Depth 3rd Edition (Paperback)	c programming
LONGMAN STUDENTS GRAMMAR OF SPOKEN AND WRITTEN ENGLISH 1st Edition (Paperback)	written english
Sony CyberShot DSC-WX300 Point & Shoot (Black)	sony cybershot
Titan Octane Analog Watch  - For Men (Brown)	titan watch
Tommy Hilfiger Analog Watch  - For Men (Black)	tommy watch
Practical Everyday English: A Self-study Method of Spoken English for Upper Intermediate and Advanced Students (Paperback)	spoken english
Case Logic TBC-401 Camera Bag (Black)	camera
5 more combos	camera
Dell Meridian II Backpack - Fits Laptops of Screen Size...	dell laptops
Nike Basic Purple Deodorant Spray  -  200 ml (For Women)	nike-deodrant
Panasonic HC-V110 Camcorder	camcorder
Data Structures, Algorithms and Applications in C++ 2 Edition (Paperback)	data structures algorithms
Axe Apollo Deodorant Spray  -  150 ml (For Men)	axe deo
Timex Analog Watch  - For Women (White)	timex watch
Statistical Thermodynamics New ed Edition (Paperback)	physics
Timex Analog Watch (Golden)	timex watch
Titan Karishma Analog Watch  - For Men (Silver)	titan watch
Timex Analog Watch  - For Men (Burgundy)	timex watch
Nike Original Deodorant Spray  -  200 ml (For Women)	nike-deodrant
Objective Approach to Mathematics for JEE Main & Advanced and Other Engineering Entrances (Volume - 1) (Paperback)	mathematics
Tommy Hilfiger Mariner Analog Watch  - For Men (Black)	tommy watch
Study Guide IBPS Institute of Banking Personnel Selection CWE-RRB Common Written Examination for Officers (Scale - 1) in Regional Rural Banks (Paperback)	written english
Data Structures and Algorithms in Java 3 Edition (Paperback)	data structures algorithms
Never Let Me Go (Paperback)	best-seller books
Those Pricey Thakur Girls (Paperback)	best-seller books
Object Oriented Programming in C++ 4 Edition (Paperback)	c programming
Axe Dimension Deodorant Spray  -  150 ml (For Men)	axe deo
Secret Seven Complete Boxset (Set of 15 Books) (Paperback)	best-seller books
Dell Entry Backpack (By Targus) For 16 inch Laptop (Bla...	dell laptops
Spoken English for Intermediate and Advance Level (Paperback)	spoken english
Sony Cybershot DSC-H70 Point & Shoot (Silver)	sony cybershot
Titan Karishma Analog Watch  - For Men (Black)	titan watch
A Practical Course in Spoken English (Paperback)	spoken english
Canon EOS 7D SLR (Black, Body Only)	dslr canon
Panasonic HDC-TM900 Camcorder (Black)	camcorder
Olympiad Champs Mathematics Class 5 : 18 Mock Olympiad CD with Insta Reports 1st Edition (Paperback)	mathematics
Dell Vostro 2520 Laptop (3rd Gen Ci3/ 4GB/ 500GB/ Ubunt...	dell laptops
Canon EOS 1DX SLR (Black, Body Only)	dslr canon
Canon EOS 700D SLR (Black, with  18 - 55 mm Kit)	dslr canon
My Google Chromebook (Paperback)	chromebook
Canon EOS 1100D SLR (Brown, with Kit (EF-S 18-55 IS II))	dslr canon
Titan Tycoon Analog Watch  - For Men (Silver, Gold)	titan watch
A Song of Ice and Fire (Set of 6 Books) (Paperback)	best-seller books
NEET 2013: 10 Mock Tests Physics, Chemistry, Zoology and Botany (Paperback)	chemistry
Tommy Hilfiger Analog Watch  - For Men (Silver)	tommy watch
Canon EOS 600D SLR (Black, with Kit III EF S18-55 IS II...	dslr canon
Tommy Hilfiger Tyler Analog Watch  - For Men (Black)	tommy watch
Dell Inspiron 15 3521 Laptop (3rd Gen Ci3/ 4GB/ 500GB/...	dell laptops
Calvin Klein IN2U Eau de Toilette  -  100 ml (For Men)	calvin klein
Calvin Klein CK Be Eau de Toilette  -  200 ml (For Men)	calvin klein
Tommy Hilfiger Watch	tommy watch
Nike N150 Green Storm Deodorant Spray  -  200 ml (For Men)	nike-deodrant
Canon EOS 600D SLR (Black, with Kit I EF-S18-55mm IS II...	dslr canon
Longman Student Grammar of Spoken and Written English 1st Edition (Paperback)	written english
Axe Provoke Deodorant Spray  -  150 ml (For Men)	axe deo
Nike Extreme Deodorant Spray  -  200 ml (For Women)	nike-deodrant
Introduction to Algorithms 3 Edition (Paperback)	data structures algorithms
The Bogoli: Phut Days (Paperback)	written english
DigiFlip Wizard CB001 with Rain Cover Camera Bag (Blue)	camera
Sony Cyber-shot DSC-H200 Point & Shoot (Black)	camera
Handbook Mathematics: Key Notes, Terms, Definitions & Formulae (Class 11th and 12th)	mathematics
1 more combo	camera
Sony CyberShot DSC-WX300 Point & Shoot (Blue)	sony cybershot
IIT JEE Chemistry : 35 Years Chapterwise Solved Papers 2013 - 1979 11th Edition (Paperback)	chemistry
Canon EOS 60D SLR (Black, with Kit II EF S18-135mm Lens)	dslr canon
Success Master IBPS Institute of Banking Personnel Selections CWE Common Written Examination Bank PO Probationary Officers / Management Trainees Exam (Paperback)	written english
Calvin Klein Eternity Aqua Eau de Toilette  -  100 ml (...	calvin klein
Data Structures and Algorithms with Object-Oriented Design Patterns in Java Pap/Cdr Edition (Paperback)	data structures algorithms
Bank PO and Management Trainee Common Written Exam (CWE-IBPS) Guide (Paperback)	written english
Data Structures and Algorithms Made Easy 2nd Edition (Paperback)	data structures algorithms
6 more combos	dell laptops
Chemistry Science For Class - X (Part -2) 1st Edition (Paperback)	chemistry
Newer edition available	mathematics
Case Logic DCB-302 Camera Case (Black)	camera
Physics IIT-JEE, AIEEE, NEET (Set of 2 Volumes) (Paperback)	physics
Sony Cyber-shot DSC-H300 Advance Point and shoot (Black)	sony cybershot
Modern Approach to Chemical Calculations,Mukherjee (Paperback)	chemistry
Sony Cyber-shot DSC-W710 Point & Shoot (Black)	sony cybershot
Question Bank - Physics, Chemistry and Biology for Class 12th (Set of 3 Books) 1st Edition (Paperback)	physics
Spoken English(Bansal) 02 Edition (Paperback)	spoken english
IBPS Bank Clerk Common Written Examination - Success Master 3rd Edition (Paperback)	written english
Sony HDR-CX220E Camcorder (Black)	camcorder
C : The Complete Reference 4 Edition (Paperback)	c programming
Sony HDR-PJ230E Camcorder (Black)	camcorder
Nikon ML-L3 Camera Remote Control	camera
Understanding Physics for JEE Main & Advanced Mechanics (Set of 2 Books) (Paperback)	physics
Timex Classic Analog Watch  - For Couple (Black)	timex watch
Modern Quantum Chemistry: Introduction to Advanced Electronic Structure Theory New ed Edition (Paperback)	chemistry
Let Us C++ 2nd Edition 2nd Edition (Paperback)	c programming
CBSE Chapterwise Solutions Chemistry, Mathematics and Physics for Class 12 (Set of 3 Books) (Paperback)	mathematics
Nikon Coolpix L27 Point & Shoot (Design Purple)	camera
Sony CyberShot DSC-WX50 Point & Shoot (Silver)	sony cybershot
Titan Tagged Analog Watch  - For Women (Purple)	titan watch
C++ Primer 5th  Edition (Paperback)	c programming
A Practical Book on Spoken English (Paperback)	spoken english
The Power of Your Subconscious Mind (Paperback)	best-seller books
Longman Student Grammar of Spoken and Written English Workbook (Paperback)	written english
Nike Sensual Touch Deodorant Spray  -  200 ml (For Women)	nike-deodrant